Año,Mes,Problemas técnicos,Facturación,Gestiones administrativas,Otros,Total mensual
2022,1,1507,379,267,74,2227
2022,2,1418,381,241,98,2138
2022,3,1896,546,326,99,2867
2022,4,1401,524,300,96,2321
2022,5,1280,507,250,71,2108
2022,6,1039,381,242,68,1730
2022,7,961,422,259,76,1718
2022,8,868,517,280,117,1782
2022,9,742,441,252,101,1536
2022,10,770,412,265,94,1541
2022,11,843,414,221,77,1555
